############################################################
#P   =   =   =   =   =   =   =   =   =   =   =   =   =   K#
# #### #### #### #### #### #### #### #### #### #### #### ##
#=   =   =   =   =   =   =   =   =   =   =   =   =   =   #
# #### #### #### #### #### #### #### #### #### #### #### ##
#=   =   =   =   =   =   =   =   =   =   =   =   =   =   #
# #### #### #### #### #### #### #### #### #### #### #### ##
#=   =   =   =   =   =   =   =   =   =   =   =   =   =   #
# #### #### #### #### #### #### #### #### #### #### #### ##
#=   =   =   =   =   =   =   =   =   =   =   =   =   =   #
# #### #### #### #### #### #### #### #### #### #### #### ##
#=   =   =   =   =   =   =   =   =   =   =   =   =   =   #
# #### #### #### #### #### #### #### #### #### #### #### ##
#=   =   =   =   =   =   =   =   =   =   =   =   =   =   #
# #### #### #### #### #### #### #### #### #### #### #### ##
#=   =   =   =   =   =   =   =   =   =   =   =   =   =   #
# #### #### #### #### #### #### #### #### #### #### #### ##
#=   =   =   =   =   =   =   =   =   =   =   =   =   =   #
# #### #### #### #### #### #### #### #### #### #### #### ##
#=   =   =   =   =   =   =   =   =   =   =   =   =   =   #
# #### #### #### #### #### #### #### #### #### #### #### ##
#=   =   =   =   =   =   =   =   =   =   =   =   =   =   #
# #### #### #### #### #### #### #### #### #### #### #### ##
############################################################
