WWWWWWWWWWWWWWWWWWWWWWWWWWWWWWWWWWWWWWWWWWWWWWWWWWWWWWWWWWWW
W J               KKKKK                                    W
W                                                          W
W                                                          W
W                                                          W
W                  WWWW  WWWW   WWW  WWWW                  W
W                  W  W  W   W W   W W                     W
W                  W  W  W E W W   W W                     W
W                  WWWW  WWWW  W E W WWW                   W
W                  W     W W   W   W W                     W
W                  W     W  W  W E W W                     W
W                  W     W   W  WWW  W                     W
W                                                          W
W                                                          W
W      W   W     W    WW    WWW   WWW    WWW               W
W      WW WW    WEW   W W  W     W E W  W                  W
W      W W W   WWWWW  WW   W     W   W   WWW               W
W      W   W   W   W  W W   WWW   WWW       W              W
W                                        WWW               W
W                                                          W
W                                                          W
W                 WW WW                                    W
W                W  W  W                                   W
W                W     W                                   W
W                 W   W                                    W
W                  W W                                     W
W                   W                                      W
W                                                          W
W                                                          W
WWWWWWWWWWWWWWWWWWWWWWWWWWWWWWWWWWWWWWWWWWWWWWWWWWWWWWWWWWWWW