WWWWWWWWWWWWWWWWWWWWWWWWWWWWWWWWWWWWWWWWWWWWWWWWWWWWWWWWWWWW
WJ  D  W          W          W                W    E       W
W   WWWW  WWWWWW  W  WWWWWW  WWWWWWWWWWWWWWWW W  WWWWWWWWW W
W      D  W    W  W  W    W       D        D  D  W   B   W W
W  B   D  W  D W  W  W  E W                D  D      B   W W
WWWWWWWW  W  WWW  W  W  WWW  WWWWWWWWWWWWWWWWWW  WWWWWWWW WW
W      W  W       W  W       W              D  D  D     W WW
W  D   W  WWWWWWWWWW  WWWWWWWW  WWWWWWWWWW   W  W  W K W W W
W  WWW W                 D           W   W   W  W  W   W W W
W  W B W                 D   E       W   W   W  W  WWWWW W W
W  W   WWWWWWWWWDDWWWWWWWW           WWWWW   W  W    B   W W
W  W                     W                   W  WWWWWWWWWW W
W  WWWWWWWWWWWWWDDWWWWWW W WWWWWWWWWWWWWWWWWWW           W W
W                       W W                             W WW
W WWWWWWWWWWWWWWWWWWWWWWW W WWWWWWWWWWWWWWWWWWWWWWWWWWWWWWWW
W W      K              W W W                         D   WW
W W                 B   W W W     WWWWWWWWWWWWWWWWWWW     WW
W W   WWWWWWWWWWWWWWWWWWW W W     W K                     WW
W W   D                 D D D     W B E                   WW
W W   D                 D D D     WWWWWWWWWWWWWWWWWWW     WW
W W   WWWWWWWWWWWWWWWWWDW W W      K                    W WW
W W                     W W WWWWWWWDWWWWWWWWWWWWWWWWWWWWWWWW
W WWWWWWWWWWWWWWWWWWWWWWW W                               WW
W W          D          W WWWWWWWWWWWWWWWWWWWWWWWWWWWWWWWW W
W W   E                 W                               W  W
W WWWWWWWWWWWWWWWWDDWWWWWWWWWWWWWWWWWWWWWWWWWWDDWWWWWWWWW  W
W                                                     D    W
W   B               K                       B              W
W                                                          W
WWWWWWWWWWWWWWWWWWWWWWWWWWWWWWWWWWWWWWWWWWWWWWWWWWWWWWWWWWWWW